1111111111
1P00000C01
1000011E01
100C000001
1000E00001
1111111111
