0000000000
0P00000C00
0000011000
000C000000
0000E00000
0000000000
