1111111111
1P0NNN0C01
10N0011001
100C0M0001
100NEM0001
1111111111
