11111111111111
1P000000C00001
1000011111C001
100C000000E001
1000000C000001
11111111111111 