1111111111
1P00000C01
1000011001
100C000001
1000E00000
1111111110
