1111111111
1P00000C01
1NNN011001
100C000001
1000E00001
1111111111
