1111111111
1P00000C01
1000011001
100C000001
1000EN0001
1111111111
