1111111111
1PN0000C01
1000011001
100C000001
1000E00001
1111111111
