1111111111
1P00N00C01
10M0011N01
100C0M0001
1N00E00M01
1111111111
