1111111111
1P00000C01
1000011001
100C0NNN01
1N00ENM001
1111111111
