1111111111
1P00N0NC01
1000011001
10NCN00001
1000E00001
1111111111
