11111111111111
1P000N00C00001
1000011111C001
100C0M0000E001
1000000C0N0001
11111111111111
