1111111111
1P00N00C01
1000011001
100C0M0001
1000E00001
1111111111
